βάλε	verb: aorist active imperative, 2nd person singular	βάλλω
βάλεσθε	verb: aorist middle imperative, 2nd person plural	βάλλω
βάλετε	verb: aorist active imperative, 2nd person plural	βάλλω
βάλησθε	verb: aorist middle subjunctive, 2nd person plural	βάλλω
βάληται	verb: aorist middle subjunctive, 3rd person singular	βάλλω
βάλητε	verb: aorist active subjunctive, 2nd person plural	βάλλω
βάλοι	verb: aorist active optative, 3rd person singular	βάλλω
βάλοιεν	verb: aorist active optative, 3rd person plural	βάλλω
βάλοιμεν	verb: aorist active optative, 1st person plural	βάλλω
βάλοιμι	verb: aorist active optative, 1st person singular	βάλλω
βάλοιντο	verb: aorist middle optative, 3rd person plural	βάλλω
βάλοιο	verb: aorist middle optative, 2nd person singular	βάλλω
βάλοις	verb: aorist active optative, 2nd person singular	βάλλω
βάλοισθε	verb: aorist middle optative, 2nd person plural	βάλλω
βάλοιτε	verb: aorist active optative, 2nd person plural	βάλλω
βάλοιτο	verb: aorist middle optative, 3rd person singular	βάλλω
βάλω	verb: aorist active subjunctive, 1st person singular	βάλλω
βάλωμαι	verb: aorist middle subjunctive, 1st person singular	βάλλω
βάλωμεν	verb: aorist active subjunctive, 1st person plural	βάλλω
βάλωνται	verb: aorist middle subjunctive, 3rd person plural	βάλλω
βάλωσι(ν)	verb: aorist active subjunctive, 3rd person plural	βάλλω
βάλῃ	verb: aorist active subjunctive, 3rd person singular, verb: aorist middle subjunctive, 2nd person singular	βάλλω
βάλῃς	verb: aorist active subjunctive, 2nd person singular	βάλλω
βαλέσθαι	verb: aorist middle infinitive	βάλλω
βαλέσθω	verb: aorist middle imperative, 3rd person singular	βάλλω
βαλέσθωσαν	verb: aorist middle imperative, 3rd person plural	βάλλω
βαλέτω	verb: aorist active imperative, 3rd person singular	βάλλω
βαλέτωσαν	verb: aorist active imperative, 3rd person plural	βάλλω
βαλεῖν	verb: aorist active infinitive	βάλλω
βαλοίμεθα	verb: aorist middle optative, 1st person plural	βάλλω
βαλοίμην	verb: aorist middle optative, 1st person singular	βάλλω
βαλομέναις	verb: aorist middle participle, dative plural feminine	βάλλω
βαλομένας	verb: aorist middle participle, accusative plural feminine	βάλλω
βαλομένη	verb: aorist middle participle, nominative singular feminine	βάλλω
βαλομένην	verb: aorist middle participle, accusative singular feminine	βάλλω
βαλομένης	verb: aorist middle participle, genitive singular feminine	βάλλω
βαλομένοις	verb: aorist middle participle, dative plural masculine, verb: aorist middle participle, dative plural neuter	βάλλω
βαλομένου	verb: aorist middle participle, genitive singular masculine, verb: aorist middle participle, genitive singular neuter	βάλλω
βαλομένους	verb: aorist middle participle, accusative plural masculine	βάλλω
βαλομένων	verb: aorist middle participle, genitive plural masculine, verb: aorist middle participle, genitive plural neuter	βάλλω
βαλομένῃ	verb: aorist middle participle, dative singular feminine	βάλλω
βαλομένῳ	verb: aorist middle participle, dative singular masculine, verb: aorist middle participle, dative singular neuter	βάλλω
βαλομενῶν	verb: aorist middle participle, genitive plural feminine	βάλλω
βαλουσῶν	verb: aorist active participle, genitive plural feminine	βάλλω
βαλούσαις	verb: aorist active participle, dative plural feminine	βάλλω
βαλούσας	verb: aorist active participle, accusative plural feminine	βάλλω
βαλούσης	verb: aorist active participle, genitive singular feminine	βάλλω
βαλούσῃ	verb: aorist active participle, dative singular feminine	βάλλω
βαλοῦ	verb: aorist middle imperative, 2nd person singular	βάλλω
βαλοῦσα	verb: aorist active participle, nominative singular feminine	βάλλω
βαλοῦσαι	verb: aorist active participle, nominative plural feminine	βάλλω
βαλοῦσαν	verb: aorist active participle, accusative singular feminine	βάλλω
βαλοῦσι(ν)	verb: aorist active participle, dative plural masculine, verb: aorist active participle, dative plural neuter	βάλλω
βαλόμενα	verb: aorist middle participle, accusative plural neuter, verb: aorist middle participle, nominative plural neuter	βάλλω
βαλόμεναι	verb: aorist middle participle, nominative plural feminine	βάλλω
βαλόμενοι	verb: aorist middle participle, nominative plural masculine	βάλλω
βαλόμενον	verb: aorist middle participle, accusative singular masculine, verb: aorist middle participle, accusative singular neuter, verb: aorist middle participle, nominative singular neuter	βάλλω
βαλόμενος	verb: aorist middle participle, nominative singular masculine	βάλλω
βαλόν	verb: aorist active participle, accusative singular neuter, verb: aorist active participle, nominative singular neuter	βάλλω
βαλόντα	verb: aorist active participle, accusative plural neuter, verb: aorist active participle, accusative singular masculine, verb: aorist active participle, nominative plural neuter	βάλλω
βαλόντας	verb: aorist active participle, accusative plural masculine	βάλλω
βαλόντες	verb: aorist active participle, nominative plural masculine	βάλλω
βαλόντι	verb: aorist active participle, dative singular masculine, verb: aorist active participle, dative singular neuter	βάλλω
βαλόντος	verb: aorist active participle, genitive singular masculine, verb: aorist active participle, genitive singular neuter	βάλλω
βαλόντων	verb: aorist active participle, genitive plural masculine, verb: aorist active participle, genitive plural neuter	βάλλω
βαλώμεθα	verb: aorist middle subjunctive, 1st person plural	βάλλω
βαλών	verb: aorist active participle, nominative singular masculine	βάλλω
ἐβάλεσθε	verb: aorist middle indicative, 2nd person plural	βάλλω
ἐβάλετε	verb: aorist active indicative, 2nd person plural	βάλλω
ἐβάλετο	verb: aorist middle indicative, 3rd person singular	βάλλω
ἐβάλομεν	verb: aorist active indicative, 1st person plural	βάλλω
ἐβάλοντο	verb: aorist middle indicative, 3rd person plural	βάλλω
ἐβάλου	verb: aorist middle indicative, 2nd person singular	βάλλω
ἐβαλόμεθα	verb: aorist middle indicative, 1st person plural	βάλλω
ἐβαλόμην	verb: aorist middle indicative, 1st person singular	βάλλω
ἔβαλαν	verb: aorist active indicative, 3rd person plural	βάλλω
ἔβαλε(ν)	verb: aorist active indicative, 3rd person singular	βάλλω
ἔβαλες	verb: aorist active indicative, 2nd person singular	βάλλω
ἔβαλον	verb: aorist active indicative, 1st person singular, verb: aorist active indicative, 3rd person plural	βάλλω
γράφητε	verb: aorist passive imperative, 2nd person plural	γράφω
γράφητι	verb: aorist passive imperative, 2nd person singular	γράφω
γραφέν	verb: aorist passive participle, accusative singular neuter, verb: aorist passive participle, nominative singular neuter	γράφω
γραφέντα	verb: aorist passive participle, accusative plural neuter, verb: aorist passive participle, accusative singular masculine, verb: aorist passive participle, nominative plural neuter	γράφω
γραφέντας	verb: aorist passive participle, accusative plural masculine	γράφω
γραφέντες	verb: aorist passive participle, nominative plural masculine	γράφω
γραφέντος	verb: aorist passive participle, genitive singular masculine, verb: aorist passive participle, genitive singular neuter	γράφω
γραφέντων	verb: aorist passive participle, genitive plural masculine, verb: aorist passive participle, genitive plural neuter	γράφω
γραφέντῳ	verb: aorist passive participle, dative singular masculine, verb: aorist passive participle, dative singular neuter	γράφω
γραφήσεσθαι	verb: future passive infinitive	γράφω
γραφήσεσθε	verb: future passive indicative, 2nd person plural	γράφω
γραφήσεται	verb: future passive indicative, 3rd person singular	γράφω
γραφήσομαι	verb: future passive indicative, 1st person singular	γράφω
γραφήσονται	verb: future passive indicative, 3rd person plural	γράφω
γραφήσῃ	verb: future passive indicative, 2nd person singular	γράφω
γραφήτω	verb: aorist passive imperative, 3rd person singular	γράφω
γραφήτωσαν	verb: aorist passive imperative, 3rd person plural	γράφω
γραφείη	verb: aorist passive optative, 3rd person singular	γράφω
γραφείην	verb: aorist passive optative, 1st person singular	γράφω
γραφείης	verb: aorist passive optative, 2nd person singular	γράφω
γραφείς	verb: aorist passive participle, nominative singular masculine	γράφω
γραφείσαις	verb: aorist passive participle, dative plural feminine	γράφω
γραφείσας	verb: aorist passive participle, accusative plural feminine	γράφω
γραφείσης	verb: aorist passive participle, genitive singular feminine	γράφω
γραφείσῃ	verb: aorist passive participle, dative singular feminine	γράφω
γραφεισῶν	verb: aorist passive participle, genitive plural feminine	γράφω
γραφεῖεν	verb: aorist passive optative, 3rd person plural	γράφω
γραφεῖμεν	verb: aorist passive optative, 1st person plural	γράφω
γραφεῖσα	verb: aorist passive participle, nominative singular feminine	γράφω
γραφεῖσαι	verb: aorist passive participle, nominative plural feminine	γράφω
γραφεῖσαν	verb: aorist passive participle, accusative singular feminine	γράφω
γραφεῖσι(ν)	verb: aorist passive participle, dative plural masculine, verb: aorist passive participle, dative plural neuter	γράφω
γραφεῖτε	verb: aorist passive optative, 2nd person plural	γράφω
γραφησομέναις	verb: future passive participle, dative plural feminine	γράφω
γραφησομένας	verb: future passive participle, accusative plural feminine	γράφω
γραφησομένη	verb: future passive participle, nominative singular feminine	γράφω
γραφησομένην	verb: future passive participle, accusative singular feminine	γράφω
γραφησομένης	verb: future passive participle, genitive singular feminine	γράφω
γραφησομένοις	verb: future passive participle, dative plural masculine, verb: future passive participle, dative plural neuter	γράφω
γραφησομένου	verb: future passive participle, genitive singular masculine, verb: future passive participle, genitive singular neuter	γράφω
γραφησομένους	verb: future passive participle, accusative plural masculine	γράφω
γραφησομένων	verb: future passive participle, genitive plural masculine, verb: future passive participle, genitive plural neuter	γράφω
γραφησομένῃ	verb: future passive participle, dative singular feminine	γράφω
γραφησομένῳ	verb: future passive participle, dative singular masculine, verb: future passive participle, dative singular neuter	γράφω
γραφησομενῶν	verb: future passive participle, genitive plural feminine	γράφω
γραφησόμεθα	verb: future passive indicative, 1st person plural	γράφω
γραφησόμενα	verb: future passive participle, accusative plural neuter, verb: future passive participle, nominative plural neuter	γράφω
γραφησόμεναι	verb: future passive participle, nominative plural feminine	γράφω
γραφησόμενοι	verb: future passive participle, nominative plural masculine	γράφω
γραφησόμενον	verb: future passive participle, accusative singular masculine, verb: future passive participle, accusative singular neuter, verb: future passive participle, nominative singular neuter	γράφω
γραφησόμενος	verb: future passive participle, nominative singular masculine	γράφω
γραφῆναι	verb: aorist passive infinitive	γράφω
γραφῆτε	verb: aorist passive subjunctive, 2nd person plural	γράφω
γραφῇ	verb: aorist passive subjunctive, 3rd person singular	γράφω
γραφῇς	verb: aorist passive subjunctive, 2nd person singular	γράφω
γραφῶ	verb: aorist passive subjunctive, 1st person singular	γράφω
γραφῶμεν	verb: aorist passive subjunctive, 1st person plural	γράφω
γραφῶσι(ν)	verb: aorist passive subjunctive, 3rd person plural	γράφω
ἐγράφη	verb: aorist passive indicative, 3rd person singular	γράφω
ἐγράφημεν	verb: aorist passive indicative, 1st person plural	γράφω
ἐγράφην	verb: aorist passive indicative, 1st person singular	γράφω
ἐγράφης	verb: aorist passive indicative, 2nd person singular	γράφω
ἐγράφησαν	verb: aorist passive indicative, 3rd person plural	γράφω
ἐγράφητε	verb: aorist passive indicative, 2nd person plural	γράφω
δέδομαι	verb: perfect mid/pass indicative, 1st person singular	δίδωμι
δέδονται	verb: perfect mid/pass indicative, 3rd person plural	δίδωμι
δέδοσαι	verb: perfect mid/pass indicative, 2nd person singular	δίδωμι
δέδοσθε	verb: perfect mid/pass indicative, 2nd person plural	δίδωμι
δέδοται	verb: perfect mid/pass indicative, 3rd person singular	δίδωμι
δέδωκα	verb: perfect active indicative, 1st person singular	δίδωμι
δέδωκας	verb: perfect active indicative, 2nd person singular	δίδωμι
δέδωκε(ν)	verb: perfect active indicative, 3rd person singular	δίδωμι
δίδομαι	verb: present mid/pass indicative, 1st person singular	δίδωμι
δίδονται	verb: present mid/pass indicative, 3rd person plural	δίδωμι
δίδοσαι	verb: present mid/pass indicative, 2nd person singular	δίδωμι
δίδοσθαι	verb: present mid/pass infinitive	δίδωμι
δίδοσθε	verb: present mid/pass indicative, 2nd person plural, verb: present mid/pass imperative, 2nd person plural	δίδωμι
δίδοσο	verb: present mid/pass imperative, 2nd person singular	δίδωμι
δίδοται	verb: present mid/pass indicative, 3rd person singular	δίδωμι
δίδοτε	verb: present active imperative, 2nd person plural	δίδωμι
δίδου	verb: present active imperative, 2nd person singular	δίδωμι
δεδομένα	verb: perfect mid/pass participle, accusative plural neuter, verb: perfect mid/pass participle, nominative plural neuter	δίδωμι
δεδομέναι	verb: perfect mid/pass participle, nominative plural feminine	δίδωμι
δεδομέναις	verb: perfect mid/pass participle, dative plural feminine	δίδωμι
δεδομένας	verb: perfect mid/pass participle, accusative plural feminine	δίδωμι
δεδομένη	verb: perfect mid/pass participle, nominative singular feminine	δίδωμι
δεδομένην	verb: perfect mid/pass participle, accusative singular feminine	δίδωμι
δεδομένης	verb: perfect mid/pass participle, genitive singular feminine	δίδωμι
δεδομένοι	verb: perfect mid/pass participle, nominative plural masculine	δίδωμι
δεδομένοις	verb: perfect mid/pass participle, dative plural masculine, verb: perfect mid/pass participle, dative plural neuter	δίδωμι
δεδομένον	verb: perfect mid/pass participle, accusative singular masculine, verb: perfect mid/pass participle, accusative singular neuter, verb: perfect mid/pass participle, nominative singular neuter	δίδωμι
δεδομένος	verb: perfect mid/pass participle, nominative singular masculine	δίδωμι
δεδομένου	verb: perfect mid/pass participle, genitive singular masculine, verb: perfect mid/pass participle, genitive singular neuter	δίδωμι
δεδομένους	verb: perfect mid/pass participle, accusative plural masculine	δίδωμι
δεδομένων	verb: perfect mid/pass participle, genitive plural masculine, verb: perfect mid/pass participle, genitive plural neuter	δίδωμι
δεδομένῃ	verb: perfect mid/pass participle, dative singular feminine	δίδωμι
δεδομένῳ	verb: perfect mid/pass participle, dative singular masculine, verb: perfect mid/pass participle, dative singular neuter	δίδωμι
δεδομενῶν	verb: perfect mid/pass participle, genitive plural feminine	δίδωμι
δεδωκέναι	verb: perfect active infinitive	δίδωμι
δεδωκυίαις	verb: perfect active participle, dative plural feminine	δίδωμι
δεδωκυίας	verb: perfect active participle, accusative plural feminine, verb: perfect active participle, genitive singular feminine	δίδωμι
δεδωκυίᾳ	verb: perfect active participle, dative singular feminine	δίδωμι
δεδωκυιῶν	verb: perfect active participle, genitive plural feminine	δίδωμι
δεδωκυῖα	verb: perfect active participle, nominative singular feminine	δίδωμι
δεδωκυῖαι	verb: perfect active participle, nominative plural feminine	δίδωμι
δεδωκυῖαν	verb: perfect active participle, accusative singular feminine	δίδωμι
δεδωκός	verb: perfect active participle, accusative singular neuter, verb: perfect active participle, nominative singular neuter	δίδωμι
δεδωκόσι	verb: perfect active participle, dative plural masculine, verb: perfect active participle, dative plural neuter	δίδωμι
δεδωκότα	verb: perfect active participle, accusative plural neuter, verb: perfect active participle, accusative singular masculine, verb: perfect active participle, nominative plural neuter	δίδωμι
δεδωκότας	verb: perfect active participle, accusative plural masculine	δίδωμι
δεδωκότες	verb: perfect active participle, nominative plural masculine	δίδωμι
δεδωκότι	verb: perfect active participle, dative singular masculine, verb: perfect active participle, dative singular neuter	δίδωμι
δεδωκότος	verb: perfect active participle, genitive singular masculine, verb: perfect active participle, genitive singular neuter	δίδωμι
δεδωκότων	verb: perfect active participle, genitive plural masculine, verb: perfect active participle, genitive plural neuter	δίδωμι
δεδωκώς	verb: perfect active participle, nominative singular masculine	δίδωμι
δεδόμεθα	verb: perfect mid/pass indicative, 1st person plural	δίδωμι
δεδόσθαι	verb: perfect mid/pass infinitive	δίδωμι
δεδώκαμεν	verb: perfect active indicative, 1st person plural	δίδωμι
δεδώκασι(ν)	verb: perfect active indicative, 3rd person plural	δίδωμι
δεδώκατε	verb: perfect active indicative, 2nd person plural	δίδωμι
διδομέναις	verb: present mid/pass participle, dative plural feminine	δίδωμι
διδομένας	verb: present mid/pass participle, accusative plural feminine	δίδωμι
διδομένη	verb: present mid/pass participle, nominative singular feminine	δίδωμι
διδομένην	verb: present mid/pass participle, accusative singular feminine	δίδωμι
διδομένης	verb: present mid/pass participle, genitive singular feminine	δίδωμι
διδομένοις	verb: present mid/pass participle, dative plural masculine, verb: present mid/pass participle, dative plural neuter	δίδωμι
διδομένου	verb: present mid/pass participle, genitive singular masculine, verb: present mid/pass participle, genitive singular neuter	δίδωμι
διδομένους	verb: present mid/pass participle, accusative plural masculine	δίδωμι
διδομένων	verb: present mid/pass participle, genitive plural masculine, verb: present mid/pass participle, genitive plural neuter	δίδωμι
διδομένῃ	verb: present mid/pass participle, dative singular feminine	δίδωμι
διδομένῳ	verb: present mid/pass participle, dative singular masculine, verb: present mid/pass participle, dative singular neuter	δίδωμι
διδομενῶν	verb: present mid/pass participle, genitive plural feminine	δίδωμι
διδουσῶν	verb: present active participle, genitive plural feminine	δίδωμι
διδούς	verb: present active participle, nominative singular masculine	δίδωμι
διδούσαις	verb: present active participle, dative plural feminine	δίδωμι
διδούσας	verb: present active participle, accusative plural feminine	δίδωμι
διδούσης	verb: present active participle, genitive singular feminine	δίδωμι
διδούσῃ	verb: present active participle, dative singular feminine	δίδωμι
διδοίη	verb: present active optative, 3rd person singular	δίδωμι
διδοίην	verb: present active optative, 1st person singular	δίδωμι
διδοίης	verb: present active optative, 2nd person singular	δίδωμι
διδοίμεθα	verb: present mid/pass optative, 1st person plural	δίδωμι
διδοίμην	verb: present mid/pass optative, 1st person singular	δίδωμι
διδοῖεν	verb: present active optative, 3rd person plural	δίδωμι
διδοῖμεν	verb: present active optative, 1st person plural	δίδωμι
διδοῖντο	verb: present mid/pass optative, 3rd person plural	δίδωμι
διδοῖο	verb: present mid/pass optative, 2nd person singular	δίδωμι
διδοῖσθε	verb: present mid/pass optative, 2nd person plural	δίδωμι
διδοῖτε	verb: present active optative, 2nd person plural	δίδωμι
διδοῖτο	verb: present mid/pass optative, 3rd person singular	δίδωμι
διδοῦσα	verb: present active participle, nominative singular feminine	δίδωμι
διδοῦσαι	verb: present active participle, nominative plural feminine	δίδωμι
διδοῦσαν	verb: present active participle, accusative singular feminine	δίδωμι
διδόμεθα	verb: present mid/pass indicative, 1st person plural	δίδωμι
διδόμενα	verb: present mid/pass participle, accusative plural neuter, verb: present mid/pass participle, nominative plural neuter	δίδωμι
διδόμεναι	verb: present mid/pass participle, nominative plural feminine	δίδωμι
διδόμενοι	verb: present mid/pass participle, nominative plural masculine	δίδωμι
διδόμενον	verb: present mid/pass participle, accusative singular masculine, verb: present mid/pass participle, accusative singular neuter, verb: present mid/pass participle, nominative singular neuter	δίδωμι
διδόμενος	verb: present mid/pass participle, nominative singular masculine	δίδωμι
διδόν	verb: present active participle, accusative singular neuter, verb: present active participle, nominative singular neuter	δίδωμι
διδόναι	verb: present active infinitive	δίδωμι
διδόντα	verb: present active participle, accusative plural neuter, verb: present active participle, accusative singular masculine, verb: present active participle, nominative plural neuter	δίδωμι
διδόντας	verb: present active participle, accusative plural masculine	δίδωμι
διδόντες	verb: present active participle, nominative plural masculine	δίδωμι
διδόντι	verb: present active participle, dative singular masculine, verb: present active participle, dative singular neuter	δίδωμι
διδόντος	verb: present active participle, genitive singular masculine, verb: present active participle, genitive singular neuter	δίδωμι
διδόντων	verb: present active participle, genitive plural masculine, verb: present active participle, genitive plural neuter	δίδωμι
διδόσθω	verb: present mid/pass imperative, 3rd person singular	δίδωμι
διδόσθωσαν	verb: present mid/pass imperative, 3rd person plural	δίδωμι
διδότω	verb: present active imperative, 3rd person singular	δίδωμι
διδότωσαν	verb: present active imperative, 3rd person plural	δίδωμι
διδώμεθα	verb: present mid/pass subjunctive, 1st person plural	δίδωμι
διδόασι(ν)	verb: present active indicative, 3rd person plural	δίδωμι
διδῶ	verb: present active subjunctive, 1st person singular	δίδωμι
διδῶμαι	verb: present mid/pass subjunctive, 1st person singular	δίδωμι
διδῶμεν	verb: present active subjunctive, 1st person plural	δίδωμι
διδῶνται	verb: present mid/pass subjunctive, 3rd person plural	δίδωμι
διδῶσθε	verb: present mid/pass subjunctive, 2nd person plural	δίδωμι
διδῶσι(ν)	verb: present active subjunctive, 3rd person plural	δίδωμι
διδῶτε	verb: present active subjunctive, 2nd person plural	δίδωμι
διδῷ	verb: present active subjunctive, 3rd person singular, verb: present mid/pass subjunctive, 2nd person singular	δίδωμι
διδῷς	verb: present active subjunctive, 2nd person singular	δίδωμι
διδῷται	verb: present mid/pass subjunctive, 3rd person singular	δίδωμι
διοῦσι(ν)	verb: present active participle, dative plural masculine, verb: present active participle, dative plural neuter	δίδωμι
δοαμένων	verb: aorist middle participle, genitive plural masculine	δίδωμι
δοθέν	verb: aorist passive participle, accusative singular neuter, verb: aorist passive participle, nominative singular neuter	δίδωμι
δοθέντα	verb: aorist passive participle, accusative plural neuter, verb: aorist passive participle, accusative singular masculine, verb: aorist passive participle, nominative plural neuter	δίδωμι
δοθέντας	verb: aorist passive participle, accusative plural masculine	δίδωμι
δοθέντες	verb: aorist passive participle, nominative plural masculine	δίδωμι
δοθέντος	verb: aorist passive participle, genitive singular masculine, verb: aorist passive participle, genitive singular neuter	δίδωμι
δοθέντων	verb: aorist passive participle, genitive plural masculine, verb: aorist passive participle, genitive plural neuter, verb: aorist passive imperative, 3rd person plural	δίδωμι
δοθέντῳ	verb: aorist passive participle, dative singular masculine, verb: aorist passive participle, dative singular neuter	δίδωμι
δοθήναι	verb: aorist passive infinitive	δίδωμι
δοθήσεσθε	verb: future passive indicative, 2nd person plural	δίδωμι
δοθήσεται	verb: future passive indicative, 3rd person singular	δίδωμι
δοθήσομαι	verb: future passive indicative, 1st person singular	δίδωμι
δοθήσονται	verb: future passive indicative, 3rd person plural	δίδωμι
δοθήσῃ	verb: future passive indicative, 2nd person singular	δίδωμι
δοθήτω	verb: aorist passive imperative, 3rd person singular	δίδωμι
δοθείς	verb: aorist passive participle, nominative singular masculine	δίδωμι
δοθείσαις	verb: aorist passive participle, dative plural feminine	δίδωμι
δοθείσας	verb: aorist passive participle, accusative plural feminine	δίδωμι
δοθείσης	verb: aorist passive participle, genitive singular feminine	δίδωμι
δοθείσῃ	verb: aorist passive participle, dative singular feminine	δίδωμι
δοθεισῶν	verb: aorist passive participle, genitive plural feminine	δίδωμι
δοθείη	verb: aorist passive optative, 3rd person singular	δίδωμι
δοθείην	verb: aorist passive optative, 1st person singular	δίδωμι
δοθείης	verb: aorist passive optative, 2nd person singular	δίδωμι
δοθεῖεν	verb: aorist passive optative, 3rd person plural	δίδωμι
δοθεῖμεν	verb: aorist passive optative, 1st person plural	δίδωμι
δοθεῖσα	verb: aorist passive participle, nominative singular feminine	δίδωμι
δοθεῖσαι	verb: aorist passive participle, nominative plural feminine	δίδωμι
δοθεῖσαν	verb: aorist passive participle, accusative singular feminine	δίδωμι
δοθεῖσι(ν)	verb: aorist passive participle, dative plural masculine, verb: aorist passive participle, dative plural neuter	δίδωμι
δοθεῖτε	verb: aorist passive optative, 2nd person plural	δίδωμι
δοθησόμεθα	verb: future passive indicative, 1st person plural	δίδωμι
δοθῆτε	verb: aorist passive subjunctive, 2nd person plural	δίδωμι
δοθῇ	verb: aorist passive subjunctive, 3rd person singular	δίδωμι
δοθῇς	verb: aorist passive subjunctive, 2nd person singular	δίδωμι
δοθῶ	verb: aorist passive subjunctive, 1st person singular	δίδωμι
δοθῶμεν	verb: aorist passive subjunctive, 1st person plural	δίδωμι
δοθῶσι(ν)	verb: aorist passive subjunctive, 3rd person plural	δίδωμι
δομέναις	verb: aorist middle participle, dative plural feminine	δίδωμι
δομένας	verb: aorist middle participle, accusative plural feminine	δίδωμι
δομένη	verb: aorist middle participle, nominative singular feminine	δίδωμι
δομένην	verb: aorist middle participle, accusative singular feminine	δίδωμι
δομένης	verb: aorist middle participle, genitive singular feminine	δίδωμι
δομένοις	verb: aorist middle participle, dative plural masculine, verb: aorist middle participle, dative plural neuter	δίδωμι
δομένου	verb: aorist middle participle, genitive singular masculine, verb: aorist middle participle, genitive singular neuter	δίδωμι
δομένους	verb: aorist middle participle, accusative plural masculine	δίδωμι
δομένων	verb: aorist middle participle, genitive plural neuter	δίδωμι
δομένῃ	verb: aorist middle participle, dative singular feminine	δίδωμι
δομένῳ	verb: aorist middle participle, dative singular masculine, verb: aorist middle participle, dative singular neuter	δίδωμι
δομενῶν	verb: aorist middle participle, genitive plural feminine	δίδωμι
δουσῶν	verb: aorist active participle, genitive plural feminine	δίδωμι
δούς	verb: aorist active participle, nominative singular masculine	δίδωμι
δούσαις	verb: aorist active participle, dative plural feminine	δίδωμι
δούσης	verb: aorist active participle, genitive singular feminine	δίδωμι
δούσσας	verb: aorist active participle, accusative plural feminine	δίδωμι
δούσῃ	verb: aorist active participle, dative singular feminine	δίδωμι
δοίη	verb: aorist active optative, 3rd person singular	δίδωμι
δοίην	verb: aorist active optative, 1st person singular	δίδωμι
δοίης	verb: aorist active optative, 2nd person singular	δίδωμι
δοίμεθα	verb: aorist middle optative, 1st person plural	δίδωμι
δοίμην	verb: aorist middle optative, 1st person singular	δίδωμι
δοῖεν	verb: aorist active optative, 3rd person plural	δίδωμι
δοῖμεν	verb: aorist active optative, 1st person plural	δίδωμι
δοῖντο	verb: aorist middle optative, 3rd person plural	δίδωμι
δοῖο	verb: aorist middle optative, 2nd person singular	δίδωμι
δοῖσθε	verb: aorist middle optative, 2nd person plural	δίδωμι
δοῖτε	verb: aorist active optative, 2nd person plural	δίδωμι
δοῖτο	verb: aorist middle optative, 3rd person singular	δίδωμι
δοῦ	verb: aorist middle imperative, 2nd person singular	δίδωμι
δοῦναι	verb: aorist active infinitive	δίδωμι
δοῦσα	verb: aorist active participle, nominative singular feminine	δίδωμι
δοῦσαι	verb: aorist active participle, nominative plural feminine	δίδωμι
δοῦσαν	verb: aorist active participle, accusative singular feminine	δίδωμι
δοῦσι(ν)	verb: aorist active participle, dative plural masculine, verb: aorist active participle, dative plural neuter	δίδωμι
δωσόμεθα	verb: future middle indicative, 1st person plural	δίδωμι
δόθητε	verb: aorist passive imperative, 2nd person plural	δίδωμι
δόθητι	verb: aorist passive imperative, 2nd person singular	δίδωμι
δόμενα	verb: aorist middle participle, accusative plural neuter, verb: aorist middle participle, nominative plural neuter	δίδωμι
δόμεναι	verb: aorist middle participle, nominative plural feminine	δίδωμι
δόμενοι	verb: aorist middle participle, nominative plural masculine	δίδωμι
δόμενον	verb: aorist middle participle, accusative singular masculine, verb: aorist middle participle, accusative singular neuter, verb: aorist middle participle, nominative singular neuter	δίδωμι
δόμενος	verb: aorist middle participle, nominative singular masculine	δίδωμι
δόν	verb: aorist active participle, accusative singular neuter, verb: aorist active participle, nominative singular neuter	δίδωμι
δόντα	verb: aorist active participle, accusative plural neuter, verb: aorist active participle, accusative singular masculine, verb: aorist active participle, nominative plural neuter	δίδωμι
δόντας	verb: aorist active participle, accusative plural masculine	δίδωμι
δόντες	verb: aorist active participle, nominative plural masculine	δίδωμι
δόντι	verb: aorist active participle, dative singular masculine, verb: aorist active participle, dative singular neuter	δίδωμι
δόντος	verb: aorist active participle, genitive singular masculine, verb: aorist active participle, genitive singular neuter	δίδωμι
δόντων	verb: aorist active participle, genitive plural masculine, verb: aorist active participle, genitive plural neuter	δίδωμι
δός	verb: aorist active imperative, 2nd person singular	δίδωμι
δόσθαι	verb: aorist middle infinitive	δίδωμι
δόσθε	verb: aorist middle imperative, 2nd person plural	δίδωμι
δόσθω	verb: aorist middle imperative, 3rd person singular	δίδωμι
δόσθωσαν	verb: aorist middle imperative, 3rd person plural	δίδωμι
δότε	verb: aorist active imperative, 2nd person plural	δίδωμι
δότω	verb: aorist active imperative, 3rd person singular	δίδωμι
δότωσαν	verb: aorist active imperative, 3rd person plural	δίδωμι
δώμεθα	verb: aorist middle subjunctive, 1st person plural	δίδωμι
δώσει	verb: future active indicative, 3rd person singular	δίδωμι
δώσεις	verb: future active indicative, 2nd person singular	δίδωμι
δώσεσθε	verb: future middle indicative, 2nd person plural	δίδωμι
δώσεται	verb: future middle indicative, 3rd person singular	δίδωμι
δώσετε	verb: future active indicative, 2nd person plural	δίδωμι
δώσομαι	verb: future middle indicative, 1st person singular	δίδωμι
δώσομεν	verb: future active indicative, 1st person plural	δίδωμι
δώσω	verb: future active indicative, 1st person singular	δίδωμι
δώσῃ	verb: future middle indicative, 2nd person singular	δίδωμι
δὠσονται	verb: future middle indicative, 3rd person plural	δίδωμι
δὠσουσι(ν)	verb: future active indicative, 3rd person plural	δίδωμι
δίδομεν	verb: present active indicative, 1st person plural	δίδωμι
δίδοτε	verb: present active indicative, 2nd person plural	δίδωμι
δίδωμι	verb: present active indicative, 1st person singular	δίδωμι
δίδως	verb: present active indicative, 2nd person singular	δίδωμι
δίδωσι(ν)	verb: present active indicative, 3rd person singular	δίδωμι
δῶ	verb: aorist active subjunctive, 1st person singular, verb: aorist middle subjunctive, 2nd person singular	δίδωμι
δῶμαι	verb: aorist middle subjunctive, 1st person singular	δίδωμι
δῶμεν	verb: aorist active subjunctive, 1st person plural	δίδωμι
δῶνται	verb: aorist middle subjunctive, 3rd person plural	δίδωμι
δῶσθε	verb: aorist middle subjunctive, 2nd person plural	δίδωμι
δῶσι(ν)	verb: aorist active subjunctive, 3rd person plural	δίδωμι
δῶται	verb: aorist middle subjunctive, 3rd person singular	δίδωμι
δῶτε	verb: aorist active subjunctive, 2nd person plural	δίδωμι
δῷ	verb: aorist active subjunctive, 3rd person singular	δίδωμι
δῷς	verb: aorist active subjunctive, 2nd person singular	δίδωμι
ἐδέδοντο	verb: pluperfect mid/pass indicative, 3rd person plural	δίδωμι
ἐδέδοσθε	verb: pluperfect mid/pass indicative, 2nd person plural	δίδωμι
ἐδέδοσο	verb: pluperfect mid/pass indicative, 2nd person singular	δίδωμι
ἐδέδοτο	verb: pluperfect mid/pass indicative, 3rd person singular	δίδωμι
ἐδεδόμεθα	verb: pluperfect mid/pass indicative, 1st person plural	δίδωμι
ἐδεδόμην	verb: pluperfect mid/pass indicative, 1st person singular	δίδωμι
ἐδεδώκει	verb: pluperfect active indicative, 3rd person singular	δίδωμι
ἐδεδώκειμεν	verb: pluperfect active indicative, 1st person plural	δίδωμι
ἐδεδώκειν	verb: pluperfect active indicative, 1st person singular	δίδωμι
ἐδεδώκεις	verb: pluperfect active indicative, 2nd person singular	δίδωμι
ἐδεδώκειτε	verb: pluperfect active indicative, 2nd person plural	δίδωμι
ἐδεδώκεσαν	verb: pluperfect active indicative, 3rd person plural	δίδωμι
ἐδιδόμεθα	verb: imperfect mid/pass indicative, 1st person plural	δίδωμι
ἐδιδόμην	verb: imperfect mid/pass indicative, 1st person singular	δίδωμι
ἐδόθη	verb: aorist passive indicative, 3rd person singular	δίδωμι
ἐδόθημεν	verb: aorist passive indicative, 1st person plural	δίδωμι
ἐδόθην	verb: aorist passive indicative, 1st person singular	δίδωμι
ἐδόθης	verb: aorist passive indicative, 2nd person singular	δίδωμι
ἐδόθησαν	verb: aorist passive indicative, 3rd person plural	δίδωμι
ἐδόθητε	verb: aorist passive indicative, 2nd person plural	δίδωμι
ἐδόμεθα	verb: aorist middle indicative, 1st person plural	δίδωμι
ἐδόμην	verb: aorist middle indicative, 1st person singular	δίδωμι
ἐδώκαμεν	verb: aorist active indicative, 1st person plural	δίδωμι
ἐδώκατε	verb: aorist active indicative, 2nd person plural	δίδωμι
ἐδίδομεν	verb: imperfect active indicative, 1st person plural	δίδωμι
ἐδίδοντο	verb: imperfect mid/pass indicative, 3rd person plural	δίδωμι
ἐδίδοσαν	verb: imperfect active indicative, 3rd person plural	δίδωμι
ἐδίδοσθε	verb: imperfect mid/pass indicative, 2nd person plural	δίδωμι
ἐδίδοσο	verb: imperfect mid/pass indicative, 2nd person singular	δίδωμι
ἐδίδοτε	verb: imperfect active indicative, 2nd person plural	δίδωμι
ἐδίδοτο	verb: imperfect mid/pass indicative, 3rd person singular	δίδωμι
ἐδίδου	verb: imperfect active indicative, 3rd person singular	δίδωμι
ἐδίδουν	verb: imperfect active indicative, 1st person singular	δίδωμι
ἐδίδους	verb: imperfect active indicative, 2nd person singular	δίδωμι
ἔδοντο	verb: aorist middle indicative, 3rd person plural	δίδωμι
ἔδοσθε	verb: aorist middle indicative, 2nd person plural	δίδωμι
ἔδοτο	verb: aorist middle indicative, 3rd person singular	δίδωμι
ἔδου	verb: aorist middle indicative, 2nd person singular	δίδωμι
ἔδωκα	verb: aorist active indicative, 1st person singular	δίδωμι
ἔδωκαν	verb: aorist active indicative, 3rd person plural	δίδωμι
ἔδωκας	verb: aorist active indicative, 2nd person singular	δίδωμι
ἔδωκε(ν)	verb: aorist active indicative, 3rd person singular	δίδωμι
δήλου	verb: present active imperative, 2nd person singular	δηλόω
δηλοίμεθα	verb: present mid/pass optative, 1st person plural	δηλόω
δηλοίμην	verb: present mid/pass optative, 1st person singular	δηλόω
δηλουμέναις	verb: present mid/pass participle, dative plural feminine	δηλόω
δηλουμένας	verb: present mid/pass participle, accusative plural feminine	δηλόω
δηλουμένη	verb: present mid/pass participle, nominative singular feminine	δηλόω
δηλουμένην	verb: present mid/pass participle, accusative singular feminine	δηλόω
δηλουμένης	verb: present mid/pass participle, genitive singular feminine	δηλόω
δηλουμένοις	verb: present mid/pass participle, dative plural masculine, verb: present mid/pass participle, dative plural neuter	δηλόω
δηλουμένου	verb: present mid/pass participle, genitive singular masculine, verb: present mid/pass participle, genitive singular neuter	δηλόω
δηλουμένους	verb: present mid/pass participle, accusative plural masculine	δηλόω
δηλουμένων	verb: present mid/pass participle, genitive plural masculine, verb: present mid/pass participle, genitive plural neuter	δηλόω
δηλουμένῃ	verb: present mid/pass participle, dative singular feminine	δηλόω
δηλουμένῳ	verb: present mid/pass participle, dative singular masculine, verb: present mid/pass participle, dative singular neuter	δηλόω
δηλουμενῶν	verb: present mid/pass participle, genitive plural feminine	δηλόω
δηλουσῶν	verb: present active participle, genitive plural feminine	δηλόω
δηλούμεθα	verb: present mid/pass indicative, 1st person plural	δηλόω
δηλούμενα	verb: present mid/pass participle, accusative plural neuter, verb: present mid/pass participle, nominative plural neuter	δηλόω
δηλούμεναι	verb: present mid/pass participle, nominative plural feminine	δηλόω
δηλούμενοι	verb: present mid/pass participle, nominative plural masculine	δηλόω
δηλούμενον	verb: present mid/pass participle, accusative singular masculine, verb: present mid/pass participle, accusative singular neuter, verb: present mid/pass participle, nominative singular neuter	δηλόω
δηλούμενος	verb: present mid/pass participle, nominative singular masculine	δηλόω
δηλούντων	verb: present active participle, genitive plural masculine, verb: present active participle, genitive plural neuter, verb: present active imperative, 3rd person plural	δηλόω
δηλούσαις	verb: present active participle, dative plural feminine	δηλόω
δηλούσας	verb: present active participle, accusative plural feminine	δηλόω
δηλούσης	verb: present active participle, genitive singular feminine	δηλόω
δηλούσθω	verb: present mid/pass imperative, 3rd person singular	δηλόω
δηλούσθωσαν	verb: present mid/pass imperative, 3rd person plural	δηλόω
δηλούσῃ	verb: present active participle, dative singular feminine	δηλόω
δηλούτω	verb: present active imperative, 3rd person singular	δηλόω
δηλοῖ	verb: present active indicative, 3rd person singular, verb: present active optative, 3rd person singular, verb: present active subjunctive, 3rd person singular, verb: present mid/pass indicative, 2nd person singular, verb: present mid/pass subjunctive, 2nd person singular	δηλόω
δηλοῖεν	verb: present active optative, 3rd person plural	δηλόω
δηλοῖμεν	verb: present active optative, 1st person plural	δηλόω
δηλοῖμι	verb: present active optative, 1st person singular	δηλόω
δηλοῖντο	verb: present mid/pass optative, 3rd person plural	δηλόω
δηλοῖο	verb: present mid/pass optative, 2nd person singular	δηλόω
δηλοῖς	verb: present active indicative, 2nd person singular, verb: present active optative, 2nd person singular, verb: present active subjunctive, 2nd person singular	δηλόω
δηλοῖσθε	verb: present mid/pass optative, 2nd person plural	δηλόω
δηλοῖτε	verb: present active optative, 2nd person plural	δηλόω
δηλοῖτο	verb: present mid/pass optative, 3rd person singular	δηλόω
δηλοῦ	verb: present mid/pass imperative, 2nd person singular	δηλόω
δηλοῦμαι	verb: present mid/pass indicative, 1st person singular	δηλόω
δηλοῦμεν	verb: present active indicative, 1st person plural	δηλόω
δηλοῦν	verb: present active infinitive, verb: present active participle, accusative singular neuter, verb: present active participle, nominative singular neuter	δηλόω
δηλοῦντα	verb: present active participle, accusative plural neuter, verb: present active participle, accusative singular masculine, verb: present active participle, nominative plural neuter	δηλόω
δηλοῦνται	verb: present mid/pass indicative, 3rd person plural	δηλόω
δηλοῦντας	verb: present active participle, accusative plural masculine	δηλόω
δηλοῦντες	verb: present active participle, nominative plural masculine	δηλόω
δηλοῦντι	verb: present active participle, dative singular masculine, verb: present active participle, dative singular neuter	δηλόω
δηλοῦντος	verb: present active participle, genitive singular masculine, verb: present active participle, genitive singular neuter	δηλόω
δηλοῦσα	verb: present active participle, nominative singular feminine	δηλόω
δηλοῦσαι	verb: present active participle, nominative plural feminine	δηλόω
δηλοῦσαν	verb: present active participle, accusative singular feminine	δηλόω
δηλοῦσθαι	verb: present mid/pass infinitive	δηλόω
δηλοῦσθε	verb: present mid/pass indicative, 2nd person plural, verb: present mid/pass imperative, 2nd person plural	δηλόω
δηλοῦσι(ν)	verb: present active indicative, 3rd person plural, verb: present active participle, dative plural masculine, verb: present active participle, dative plural neuter	δηλόω
δηλοῦται	verb: present mid/pass indicative, 3rd person singular	δηλόω
δηλοῦτε	verb: present active indicative, 2nd person plural, verb: present active imperative, 2nd person plural	δηλόω
δηλώμεθα	verb: present mid/pass subjunctive, 1st person plural	δηλόω
δηλῶ	verb: present active indicative, 1st person singular, verb: present active subjunctive, 1st person singular	δηλόω
δηλῶμαι	verb: present mid/pass subjunctive, 1st person singular	δηλόω
δηλῶμεν	verb: present active subjunctive, 1st person plural	δηλόω
δηλῶν	verb: present active participle, nominative singular masculine	δηλόω
δηλῶνται	verb: present mid/pass subjunctive, 3rd person plural	δηλόω
δηλῶσθε	verb: present mid/pass subjunctive, 2nd person plural	δηλόω
δηλῶσι(ν)	verb: present active subjunctive, 3rd person plural	δηλόω
δηλῶται	verb: present mid/pass subjunctive, 3rd person singular	δηλόω
δηλῶτε	verb: present active subjunctive, 2nd person plural	δηλόω
ἐδήλου	verb: imperfect active indicative, 3rd person singular	δηλόω
ἐδήλουν	verb: imperfect active indicative, 1st person singular, verb: imperfect active indicative, 3rd person plural	δηλόω
ἐδήλους	verb: imperfect active indicative, 2nd person singular	δηλόω
ἐδηλούμεθα	verb: imperfect mid/pass indicative, 1st person plural	δηλόω
ἐδηλούμην	verb: imperfect mid/pass indicative, 1st person singular	δηλόω
ἐδηλοῦ	verb: imperfect mid/pass indicative, 2nd person singular	δηλόω
ἐδηλοῦμεν	verb: imperfect active indicative, 1st person plural	δηλόω
ἐδηλοῦντο	verb: imperfect mid/pass indicative, 3rd person plural	δηλόω
ἐδηλοῦσθε	verb: imperfect mid/pass indicative, 2nd person plural	δηλόω
ἐδηλοῦτε	verb: imperfect active indicative, 2nd person plural	δηλόω
ἐδηλοῦτο	verb: imperfect mid/pass indicative, 3rd person singular	δηλόω
λέλυκα	verb: perfect active indicative, 1st person singular	λύω
λέλυκας	verb: perfect active indicative, 2nd person singular	λύω
λέλυκε(ν)	verb: perfect active indicative, 3rd person singular	λύω
λέλυμαι	verb: perfect mid/pass indicative, 1st person singular	λύω
λέλυνται	verb: perfect mid/pass indicative, 3rd person plural	λύω
λέλυσαι	verb: perfect mid/pass indicative, 2nd person singular	λύω
λέλυσθε	verb: perfect mid/pass indicative, 2nd person plural	λύω
λέλυται	verb: perfect mid/pass indicative, 3rd person singular	λύω
λελυκέναι	verb: perfect active infinitive	λύω
λελυκυίαις	verb: perfect active participle, dative plural feminine	λύω
λελυκυίας	verb: perfect active participle, accusative plural feminine, verb: perfect active participle, genitive singular feminine	λύω
λελυκυίᾳ	verb: perfect active participle, dative singular feminine	λύω
λελυκυιῶν	verb: perfect active participle, genitive plural feminine	λύω
λελυκυῖα	verb: perfect active participle, nominative singular feminine	λύω
λελυκυῖαι	verb: perfect active participle, nominative plural feminine	λύω
λελυκυῖαν	verb: perfect active participle, accusative singular feminine	λύω
λελυκός	verb: perfect active participle, accusative singular neuter, verb: perfect active participle, nominative singular neuter	λύω
λελυκόσι(ν)	verb: perfect active participle, dative plural masculine, verb: perfect active participle, dative plural neuter	λύω
λελυκότα	verb: perfect active participle, accusative plural neuter, verb: perfect active participle, accusative singular masculine, verb: perfect active participle, nominative plural neuter	λύω
λελυκότας	verb: perfect active participle, accusative plural masculine	λύω
λελυκότες	verb: perfect active participle, nominative plural masculine	λύω
λελυκότι	verb: perfect active participle, dative singular masculine, verb: perfect active participle, dative singular neuter	λύω
λελυκότος	verb: perfect active participle, genitive singular masculine, verb: perfect active participle, genitive singular neuter	λύω
λελυκότων	verb: perfect active participle, genitive plural masculine, verb: perfect active participle, genitive plural neuter	λύω
λελυκώς	verb: perfect active participle, nominative singular masculine	λύω
λελυμένα	verb: perfect mid/pass participle, accusative plural neuter, verb: perfect mid/pass participle, nominative plural neuter	λύω
λελυμέναι	verb: perfect mid/pass participle, nominative plural feminine	λύω
λελυμέναις	verb: perfect mid/pass participle, dative plural feminine	λύω
λελυμένας	verb: perfect mid/pass participle, accusative plural feminine	λύω
λελυμένη	verb: perfect mid/pass participle, nominative singular feminine	λύω
λελυμένην	verb: perfect mid/pass participle, accusative singular feminine	λύω
λελυμένης	verb: perfect mid/pass participle, genitive singular feminine	λύω
λελυμένοι	verb: perfect mid/pass participle, nominative plural masculine	λύω
λελυμένοις	verb: perfect mid/pass participle, dative plural masculine, verb: perfect mid/pass participle, dative plural neuter	λύω
λελυμένον	verb: perfect mid/pass participle, accusative singular masculine, verb: perfect mid/pass participle, accusative singular neuter, verb: perfect mid/pass participle, nominative singular neuter	λύω
λελυμένος	verb: perfect mid/pass participle, nominative singular masculine	λύω
λελυμένου	verb: perfect mid/pass participle, genitive singular masculine, verb: perfect mid/pass participle, genitive singular neuter	λύω
λελυμένους	verb: perfect mid/pass participle, accusative plural masculine	λύω
λελυμένων	verb: perfect mid/pass participle, genitive plural masculine, verb: perfect mid/pass participle, genitive plural neuter	λύω
λελυμένῃ	verb: perfect mid/pass participle, dative singular feminine	λύω
λελυμένῳ	verb: perfect mid/pass participle, dative singular masculine, verb: perfect mid/pass participle, dative singular neuter	λύω
λελυμενῶν	verb: perfect mid/pass participle, genitive plural feminine	λύω
λελύκαμεν	verb: perfect active indicative, 1st person plural	λύω
λελύκασι(ν)	verb: perfect active indicative, 3rd person plural	λύω
λελύκατε	verb: perfect active indicative, 2nd person plural	λύω
λελύμεθα	verb: perfect mid/pass indicative, 1st person plural	λύω
λελύσθαι	verb: perfect mid/pass infinitive	λύω
λυέσθω	verb: present mid/pass imperative, 3rd person singular	λύω
λυέσθωσαν	verb: present mid/pass imperative, 3rd person plural	λύω
λυέτω	verb: present active imperative, 3rd person singular	λύω
λυέτωσαν	verb: present active imperative, 3rd person plural	λύω
λυθέν	verb: aorist passive participle, accusative singular neuter, verb: aorist passive participle, nominative singular neuter	λύω
λυθέντα	verb: aorist passive participle, accusative plural neuter, verb: aorist passive participle, accusative singular masculine, verb: aorist passive participle, nominative plural neuter	λύω
λυθέντας	verb: aorist passive participle, accusative plural masculine	λύω
λυθέντες	verb: aorist passive participle, nominative plural masculine	λύω
λυθέντος	verb: aorist passive participle, genitive singular masculine, verb: aorist passive participle, genitive singular neuter	λύω
λυθέντων	verb: aorist passive participle, genitive plural masculine, verb: aorist passive participle, genitive plural neuter	λύω
λυθέντῳ	verb: aorist passive participle, dative singular masculine, verb: aorist passive participle, dative singular neuter	λύω
λυθήσεσθαι	verb: future passive infinitive	λύω
λυθήσεσθε	verb: future passive indicative, 2nd person plural	λύω
λυθήσεται	verb: future passive indicative, 3rd person singular	λύω
λυθήσομαι	verb: future passive indicative, 1st person singular	λύω
λυθήσονται	verb: future passive indicative, 3rd person plural	λύω
λυθήσῃ	verb: future passive indicative, 2nd person singular	λύω
λυθήτω	verb: aorist passive imperative, 3rd person singular	λύω
λυθήτωσαν	verb: aorist passive imperative, 3rd person plural	λύω
λυθείη	verb: aorist passive optative, 3rd person singular	λύω
λυθείην	verb: aorist passive optative, 1st person singular	λύω
λυθείης	verb: aorist passive optative, 2nd person singular	λύω
λυθείς	verb: aorist passive participle, nominative singular masculine	λύω
λυθείσαις	verb: aorist passive participle, dative plural feminine	λύω
λυθείσας	verb: aorist passive participle, accusative plural feminine	λύω
λυθείσης	verb: aorist passive participle, genitive singular feminine	λύω
λυθείσῃ	verb: aorist passive participle, dative singular feminine	λύω
λυθεισῶν	verb: aorist passive participle, genitive plural feminine	λύω
λυθεῖεν	verb: aorist passive optative, 3rd person plural	λύω
λυθεῖμεν	verb: aorist passive optative, 1st person plural	λύω
λυθεῖσα	verb: aorist passive participle, nominative singular feminine	λύω
λυθεῖσαι	verb: aorist passive participle, nominative plural feminine	λύω
λυθεῖσαν	verb: aorist passive participle, accusative singular feminine	λύω
λυθεῖσι(ν)	verb: aorist passive participle, dative plural masculine, verb: aorist passive participle, dative plural neuter	λύω
λυθεῖτε	verb: aorist passive optative, 2nd person plural	λύω
λυθησομέναις	verb: future passive participle, dative plural feminine	λύω
λυθησομένας	verb: future passive participle, accusative plural feminine	λύω
λυθησομένη	verb: future passive participle, nominative singular feminine	λύω
λυθησομένην	verb: future passive participle, accusative singular feminine	λύω
λυθησομένης	verb: future passive participle, genitive singular feminine	λύω
λυθησομένοις	verb: future passive participle, dative plural masculine, verb: future passive participle, dative plural neuter	λύω
λυθησομένου	verb: future passive participle, genitive singular masculine, verb: future passive participle, genitive singular neuter	λύω
λυθησομένους	verb: future passive participle, accusative plural masculine	λύω
λυθησομένων	verb: future passive participle, genitive plural masculine, verb: future passive participle, genitive plural neuter	λύω
λυθησομένῃ	verb: future passive participle, dative singular feminine	λύω
λυθησομένῳ	verb: future passive participle, dative singular masculine, verb: future passive participle, dative singular neuter	λύω
λυθησομενῶν	verb: future passive participle, genitive plural feminine	λύω
λυθησόμεθα	verb: future passive indicative, 1st person plural	λύω
λυθησόμενα	verb: future passive participle, accusative plural neuter, verb: future passive participle, nominative plural neuter	λύω
λυθησόμεναι	verb: future passive participle, nominative plural feminine	λύω
λυθησόμενοι	verb: future passive participle, nominative plural masculine	λύω
λυθησόμενον	verb: future passive participle, accusative singular masculine, verb: future passive participle, accusative singular neuter, verb: future passive participle, nominative singular neuter	λύω
λυθησόμενος	verb: future passive participle, nominative singular masculine	λύω
λυθῆναι	verb: aorist passive infinitive	λύω
λυθῆτε	verb: aorist passive subjunctive, 2nd person plural	λύω
λυθῇ	verb: aorist passive subjunctive, 3rd person singular	λύω
λυθῇς	verb: aorist passive subjunctive, 2nd person singular	λύω
λυθῶ	verb: aorist passive subjunctive, 1st person singular	λύω
λυθῶμεν	verb: aorist passive subjunctive, 1st person plural	λύω
λυθῶσι(ν)	verb: aorist passive subjunctive, 3rd person plural	λύω
λυοίμεθα	verb: present mid/pass optative, 1st person plural	λύω
λυοίμην	verb: present mid/pass optative, 1st person singular	λύω
λυομένα	verb: present mid/pass participle, accusative plural neuter	λύω
λυομέναις	verb: present mid/pass participle, dative plural feminine	λύω
λυομένας	verb: present mid/pass participle, accusative plural feminine	λύω
λυομένη	verb: present mid/pass participle, nominative singular feminine	λύω
λυομένην	verb: present mid/pass participle, accusative singular feminine	λύω
λυομένης	verb: present mid/pass participle, genitive singular feminine	λύω
λυομένοις	verb: present mid/pass participle, dative plural masculine, verb: present mid/pass participle, dative plural neuter	λύω
λυομένου	verb: present mid/pass participle, genitive singular masculine, verb: present mid/pass participle, genitive singular neuter	λύω
λυομένους	verb: present mid/pass participle, accusative plural masculine	λύω
λυομένων	verb: present mid/pass participle, genitive plural masculine, verb: present mid/pass participle, genitive plural neuter	λύω
λυομένῃ	verb: present mid/pass participle, dative singular feminine	λύω
λυομένῳ	verb: present mid/pass participle, dative singular masculine, verb: present mid/pass participle, dative singular neuter	λύω
λυομενῶν	verb: present mid/pass participle, genitive plural feminine	λύω
λυουσῶν	verb: present active participle, genitive plural feminine	λύω
λυούσαις	verb: present active participle, dative plural feminine	λύω
λυούσας	verb: present active participle, accusative plural feminine	λύω
λυούσης	verb: present active participle, genitive singular feminine	λύω
λυούσῃ	verb: present active participle, dative singular feminine	λύω
λυσάμενα	verb: aorist middle participle, accusative plural neuter, verb: aorist middle participle, nominative plural neuter	λύω
λυσάμεναι	verb: aorist middle participle, nominative plural feminine	λύω
λυσάμενοι	verb: aorist middle participle, nominative plural masculine	λύω
λυσάμενον	verb: aorist middle participle, accusative singular masculine, verb: aorist middle participle, accusative singular neuter, verb: aorist middle participle, nominative singular neuter	λύω
λυσάμενος	verb: aorist middle participle, nominative singular masculine	λύω
λυσάσθω	verb: aorist middle imperative, 3rd person singular	λύω
λυσάσθωσαν	verb: aorist middle imperative, 3rd person plural	λύω
λυσάτω	verb: aorist active imperative, 3rd person singular	λύω
λυσάτωσαν	verb: aorist active imperative, 3rd person plural	λύω
λυσαίμεθα	verb: aorist middle optative, 1st person plural	λύω
λυσαίμην	verb: aorist middle optative, 1st person singular	λύω
λυσαμέναις	verb: aorist middle participle, dative plural feminine	λύω
λυσαμένας	verb: aorist middle participle, accusative plural feminine	λύω
λυσαμένη	verb: aorist middle participle, nominative singular feminine	λύω
λυσαμένης	verb: aorist middle participle, genitive singular feminine	λύω
λυσαμένοις	verb: aorist middle participle, dative plural masculine, verb: aorist middle participle, dative plural neuter	λύω
λυσαμένου	verb: aorist middle participle, genitive singular masculine, verb: aorist middle participle, genitive singular neuter	λύω
λυσαμένους	verb: aorist middle participle, accusative plural masculine	λύω
λυσαμένων	verb: aorist middle participle, genitive plural masculine, verb: aorist middle participle, genitive plural neuter	λύω
λυσαμένῃ	verb: aorist middle participle, dative singular feminine	λύω
λυσαμένῳ	verb: aorist middle participle, dative singular masculine, verb: aorist middle participle, dative singular neuter	λύω
λυσαμενῶν	verb: aorist middle participle, genitive plural feminine	λύω
λυσασῶν	verb: aorist active participle, genitive plural feminine	λύω
λυσομέναις	verb: future middle participle, dative plural feminine	λύω
λυσομένας	verb: future middle participle, accusative plural feminine	λύω
λυσομένη	verb: future middle participle, nominative singular feminine	λύω
λυσομένην	verb: future middle participle, accusative singular feminine	λύω
λυσομένης	verb: future middle participle, genitive singular feminine	λύω
λυσομένοις	verb: future middle participle, dative plural masculine, verb: future middle participle, dative plural neuter	λύω
λυσομένου	verb: future middle participle, genitive singular masculine, verb: future middle participle, genitive singular neuter	λύω
λυσομένους	verb: future middle participle, accusative plural masculine	λύω
λυσομένων	verb: future middle participle, genitive plural masculine, verb: future middle participle, genitive plural neuter	λύω
λυσομένῃ	verb: future middle participle, dative singular feminine	λύω
λυσομένῳ	verb: future middle participle, dative singular masculine, verb: future middle participle, dative singular neuter	λύω
λυσομενῶν	verb: future middle participle, genitive plural feminine	λύω
λυσουσῶν	verb: future active participle, genitive plural feminine	λύω
λυσούσαις	verb: future active participle, dative plural feminine	λύω
λυσούσας	verb: future active participle, accusative plural feminine	λύω
λυσούσης	verb: future active participle, genitive singular feminine	λύω
λυσούσῃ	verb: future active participle, dative singular feminine	λύω
λυσόμεθα	verb: future middle indicative, 1st person plural	λύω
λυσόμενα	verb: future middle participle, accusative plural neuter, verb: future middle participle, nominative plural neuter	λύω
λυσόμεναι	verb: future middle participle, nominative plural feminine	λύω
λυσόμενοι	verb: future middle participle, nominative plural masculine	λύω
λυσόμενον	verb: future middle participle, accusative singular masculine, verb: future middle participle, accusative singular neuter, verb: future middle participle, nominative singular neuter	λύω
λυσόμενος	verb: future middle participle, nominative singular masculine	λύω
λυσόντων	verb: future active participle, genitive plural masculine, verb: future active participle, genitive plural neuter	λύω
λυσώμεθα	verb: aorist middle subjunctive, 1st person plural	λύω
λυσάντων	verb: aorist active participle, genitive plural masculine, verb: aorist active participle, genitive plural neuter	λύω
λυσάσαις	verb: aorist active participle, dative plural feminine	λύω
λυσάσας	verb: aorist active participle, accusative plural feminine	λύω
λυσάσης	verb: aorist active participle, genitive singular feminine	λύω
λυσάσῃ	verb: aorist active participle, dative singular feminine	λύω
λυόμεθα	verb: present mid/pass indicative, 1st person plural	λύω
λυόμενα	verb: present mid/pass participle, nominative plural neuter	λύω
λυόμεναι	verb: present mid/pass participle, nominative plural feminine	λύω
λυόμενοι	verb: present mid/pass participle, nominative plural masculine	λύω
λυόμενον	verb: present mid/pass participle, accusative singular masculine, verb: present mid/pass participle, accusative singular neuter, verb: present mid/pass participle, nominative singular neuter	λύω
λυόμενος	verb: present mid/pass participle, nominative singular masculine	λύω
λυόντων	verb: present active participle, genitive plural masculine, verb: present active participle, genitive plural neuter	λύω
λυώμεθα	verb: present mid/pass subjunctive, 1st person plural	λύω
λύει	verb: present active indicative, 3rd person singular	λύω
λύειν	verb: present active infinitive	λύω
λύεις	verb: present active indicative, 2nd person singular	λύω
λύεσθαι	verb: present mid/pass infinitive	λύω
λύεσθε	verb: present mid/pass indicative, 2nd person plural, verb: present mid/pass imperative, 2nd person plural	λύω
λύεται	verb: present mid/pass indicative, 3rd person singular	λύω
λύετε	verb: present active indicative, 2nd person plural, verb: present active imperative, 2nd person plural	λύω
λύησθε	verb: present mid/pass subjunctive, 2nd person plural	λύω
λύηται	verb: present mid/pass subjunctive, 3rd person singular	λύω
λύητε	verb: present active subjunctive, 2nd person plural	λύω
λύθητε	verb: aorist passive imperative, 2nd person plural	λύω
λύθητι	verb: aorist passive imperative, 2nd person singular	λύω
λύοι	verb: present active optative, 3rd person singular	λύω
λύοιεν	verb: present active optative, 3rd person plural	λύω
λύοιμεν	verb: present active optative, 1st person plural	λύω
λύοιμι	verb: present active optative, 1st person singular	λύω
λύοιντο	verb: present mid/pass optative, 3rd person plural	λύω
λύοιο	verb: present mid/pass optative, 2nd person singular	λύω
λύοις	verb: present active optative, 2nd person singular	λύω
λύοισθε	verb: present mid/pass optative, 2nd person plural	λύω
λύοιτε	verb: present active optative, 2nd person plural	λύω
λύοιτο	verb: present mid/pass optative, 3rd person singular	λύω
λύομαι	verb: present mid/pass indicative, 1st person singular	λύω
λύομεν	verb: present active indicative, 1st person plural	λύω
λύοντα	verb: present active participle, accusative plural neuter, verb: present active participle, accusative singular masculine, verb: present active participle, nominative plural neuter	λύω
λύονται	verb: present mid/pass indicative, 3rd person plural	λύω
λύοντας	verb: present active participle, accusative plural masculine	λύω
λύοντες	verb: present active participle, nominative plural masculine	λύω
λύοντι	verb: present active participle, dative singular masculine, verb: present active participle, dative singular neuter	λύω
λύοντος	verb: present active participle, genitive singular masculine, verb: present active participle, genitive singular neuter	λύω
λύου	verb: present mid/pass imperative, 2nd person singular	λύω
λύουσα	verb: present active participle, nominative singular feminine	λύω
λύουσαι	verb: present active participle, nominative plural feminine	λύω
λύουσαν	verb: present active participle, accusative singular feminine	λύω
λύουσι(ν)	verb: present active indicative, 3rd person plural, verb: present active participle, dative plural masculine, verb: present active participle, dative plural neuter	λύω
λύσαι	verb: aorist active optative, 3rd person singular	λύω
λύσαιεν	verb: aorist active optative, 3rd person plural	λύω
λύσαιμεν	verb: aorist active optative, 1st person plural	λύω
λύσαιμι	verb: aorist active optative, 1st person singular	λύω
λύσαιντο	verb: aorist middle optative, 3rd person plural	λύω
λύσαιο	verb: aorist middle optative, 2nd person singular	λύω
λύσαις	verb: aorist active optative, 2nd person singular	λύω
λύσαισθε	verb: aorist middle optative, 2nd person plural	λύω
λύσαιτε	verb: aorist active optative, 2nd person plural	λύω
λύσαιτο	verb: aorist middle optative, 3rd person singular	λύω
λύσασθαι	verb: aorist middle infinitive	λύω
λύσασθε	verb: aorist middle imperative, 2nd person plural	λύω
λύσατε	verb: aorist active imperative, 2nd person plural	λύω
λύσει	verb: future active indicative, 3rd person singular	λύω
λύσειν	verb: future active infinitive	λύω
λύσεις	verb: future active indicative, 2nd person singular	λύω
λύσεσθαι	verb: future middle infinitive	λύω
λύσεσθε	verb: future middle indicative, 2nd person plural	λύω
λύσεται	verb: future middle indicative, 3rd person singular	λύω
λύσετε	verb: future active indicative, 2nd person plural	λύω
λύσησθε	verb: aorist middle subjunctive, 2nd person plural	λύω
λύσηται	verb: aorist middle subjunctive, 3rd person singular	λύω
λύσητε	verb: aorist active subjunctive, 2nd person plural	λύω
λύσομαι	verb: future middle indicative, 1st person singular	λύω
λύσομεν	verb: future active indicative, 1st person plural	λύω
λύσοντα	verb: future active participle, accusative plural neuter, verb: future active participle, accusative singular masculine, verb: future active participle, nominative plural neuter	λύω
λύσονται	verb: future middle indicative, 3rd person plural	λύω
λύσοντας	verb: future active participle, accusative plural masculine	λύω
λύσοντες	verb: future active participle, nominative plural masculine	λύω
λύσοντι	verb: future active participle, dative singular masculine, verb: future active participle, dative singular neuter	λύω
λύσοντος	verb: future active participle, genitive singular masculine, verb: future active participle, genitive singular neuter	λύω
λύσουσα	verb: future active participle, nominative singular feminine	λύω
λύσουσαι	verb: future active participle, nominative plural feminine	λύω
λύσουσαν	verb: future active participle, accusative singular feminine	λύω
λύσουσι(ν)	verb: future active indicative, 3rd person plural, verb: future active participle, dative plural masculine, verb: future active participle, dative plural neuter	λύω
λύσω	verb: aorist active subjunctive, 1st person singular, verb: future active indicative, 1st person singular	λύω
λύσωμαι	verb: aorist middle subjunctive, 1st person singular	λύω
λύσωμεν	verb: aorist active subjunctive, 1st person plural	λύω
λύσων	verb: future active participle, nominative singular masculine	λύω
λύσωνται	verb: aorist middle subjunctive, 3rd person plural	λύω
λύσωσι(ν)	verb: aorist active subjunctive, 3rd person plural	λύω
λύσῃ	verb: aorist active subjunctive, 3rd person singular, verb: aorist middle subjunctive, 2nd person singular, verb: future middle indicative, 2nd person singular	λύω
λύσῃς	verb: aorist active subjunctive, 2nd person singular	λύω
λύω	verb: present active indicative, 1st person singular, verb: present active subjunctive, 1st person singular	λύω
λύωμαι	verb: present mid/pass subjunctive, 1st person singular	λύω
λύωμεν	verb: present active subjunctive, 1st person plural	λύω
λύων	verb: present active participle, nominative singular masculine	λύω
λύωνται	verb: present mid/pass subjunctive, 3rd person plural	λύω
λύωσι(ν)	verb: present active subjunctive, 3rd person plural	λύω
λύῃ	verb: present mid/pass indicative, 2nd person singular, verb: present active subjunctive, 3rd person singular, verb: present mid/pass subjunctive, 2nd person singular	λύω
λύῃς	verb: present active subjunctive, 2nd person singular	λύω
λύσαντα	verb: aorist active participle, accusative plural neuter, verb: aorist active participle, accusative singular masculine, verb: aorist active participle, nominative plural neuter	λύω
λύσαντας	verb: aorist active participle, accusative plural masculine	λύω
λύσαντες	verb: aorist active participle, nominative plural masculine	λύω
λύσαντι	verb: aorist active participle, dative singular masculine, verb: aorist active participle, dative singular neuter	λύω
λύσαντος	verb: aorist active participle, genitive singular masculine, verb: aorist active participle, genitive singular neuter	λύω
λύσας	verb: aorist active participle, nominative singular masculine	λύω
λύσασα	verb: aorist active participle, nominative singular feminine	λύω
λύσασαι	verb: aorist active participle, nominative plural feminine	λύω
λύσασαν	verb: aorist active participle, accusative singular feminine	λύω
λύσασι(ν)	verb: aorist active participle, dative plural masculine, verb: aorist active participle, dative plural neuter	λύω
λῦε	verb: present active imperative, 2nd person singular	λύω
λῦον	verb: present active participle, accusative singular neuter, verb: present active participle, nominative singular neuter	λύω
λῦσαι	verb: aorist active infinitive, verb: aorist middle imperative, 2nd person singular	λύω
λῦσαν	verb: aorist active participle, accusative singular neuter, verb: aorist active participle, nominative singular neuter	λύω
λῦσον	verb: aorist active imperative, 2nd person singular, verb: future active participle, accusative singular neuter, verb: future active participle, nominative singular neuter	λύω
ἐλέλυντο	verb: pluperfect mid/pass indicative, 3rd person plural	λύω
ἐλέλυσθε	verb: pluperfect mid/pass indicative, 2nd person plural	λύω
ἐλέλυσο	verb: pluperfect mid/pass indicative, 2nd person singular	λύω
ἐλέλυτο	verb: pluperfect mid/pass indicative, 3rd person singular	λύω
ἐλελύκει	verb: pluperfect active indicative, 3rd person singular	λύω
ἐλελύκεμεν	verb: pluperfect active indicative, 1st person plural	λύω
ἐλελύκεσαν	verb: pluperfect active indicative, 3rd person plural	λύω
ἐλελύκετε	verb: pluperfect active indicative, 2nd person plural	λύω
ἐλελύκη	verb: pluperfect active indicative, 1st person singular	λύω
ἐλελύκης	verb: pluperfect active indicative, 2nd person singular	λύω
ἐλελύμεθα	verb: pluperfect mid/pass indicative, 1st person plural	λύω
ἐλελύμην	verb: pluperfect mid/pass indicative, 1st person singular	λύω
ἐλυσάμεθα	verb: aorist middle indicative, 1st person plural	λύω
ἐλυσάμην	verb: aorist middle indicative, 1st person singular	λύω
ἐλυόμεθα	verb: imperfect mid/pass indicative, 1st person plural	λύω
ἐλυόμην	verb: imperfect mid/pass indicative, 1st person singular	λύω
ἐλύεσθε	verb: imperfect mid/pass indicative, 2nd person plural	λύω
ἐλύετε	verb: imperfect active indicative, 2nd person plural	λύω
ἐλύετο	verb: imperfect mid/pass indicative, 3rd person singular	λύω
ἐλύθη	verb: aorist passive indicative, 3rd person singular	λύω
ἐλύθημεν	verb: aorist passive indicative, 1st person plural	λύω
ἐλύθην	verb: aorist passive indicative, 1st person singular	λύω
ἐλύθης	verb: aorist passive indicative, 2nd person singular	λύω
ἐλύθησαν	verb: aorist passive indicative, 3rd person plural	λύω
ἐλύθητε	verb: aorist passive indicative, 2nd person plural	λύω
ἐλύομεν	verb: imperfect active indicative, 1st person plural	λύω
ἐλύοντο	verb: imperfect mid/pass indicative, 3rd person plural	λύω
ἐλύου	verb: imperfect mid/pass indicative, 2nd person singular	λύω
ἐλύσαμεν	verb: aorist active indicative, 1st person plural	λύω
ἐλύσαντο	verb: aorist middle indicative, 3rd person plural	λύω
ἐλύσασθε	verb: aorist middle indicative, 2nd person plural	λύω
ἐλύσατε	verb: aorist active indicative, 2nd person plural	λύω
ἐλύσατο	verb: aorist middle indicative, 3rd person singular	λύω
ἐλύσω	verb: aorist middle indicative, 2nd person singular	λύω
ἔλυε(ν)	verb: imperfect active indicative, 3rd person singular	λύω
ἔλυες	verb: imperfect active indicative, 2nd person singular	λύω
ἔλυον	verb: imperfect active indicative, 1st person singular, verb: imperfect active indicative, 3rd person plural	λύω
ἔλυσα	verb: aorist active indicative, 1st person singular	λύω
ἔλυσαν	verb: aorist active indicative, 3rd person plural	λύω
ἔλυσας	verb: aorist active indicative, 2nd person singular	λύω
ἔλυσε(ν)	verb: aorist active indicative, 3rd person singular	λύω
ποίει	verb: present active imperative, 2nd person singular	ποιέω
ποιείσθω	verb: present mid/pass imperative, 3rd person singular	ποιέω
ποιείσθωσαν	verb: present mid/pass imperative, 3rd person plural	ποιέω
ποιείτω	verb: present active imperative, 3rd person singular	ποιέω
ποιείτωσαν	verb: present active imperative, 3rd person plural	ποιέω
ποιεῖ	verb: present active indicative, 3rd person singular, verb: present mid/pass indicative, 2nd person singular	ποιέω
ποιεῖν	verb: present active infinitive	ποιέω
ποιεῖς	verb: present active indicative, 2nd person singular	ποιέω
ποιεῖσθαι	verb: present mid/pass infinitive	ποιέω
ποιεῖσθε	verb: present mid/pass indicative, 2nd person plural, verb: present mid/pass imperative, 2nd person plural	ποιέω
ποιεῖται	verb: present mid/pass indicative, 3rd person singular	ποιέω
ποιεῖτε	verb: present active indicative, 2nd person plural, verb: present active imperative, 2nd person plural	ποιέω
ποιοίμεθα	verb: present mid/pass optative, 1st person plural	ποιέω
ποιοίμην	verb: present mid/pass optative, 1st person singular	ποιέω
ποιουέναις	verb: present mid/pass participle, dative plural feminine	ποιέω
ποιουένας	verb: present mid/pass participle, accusative plural feminine	ποιέω
ποιουένην	verb: present mid/pass participle, accusative singular feminine	ποιέω
ποιουένης	verb: present mid/pass participle, genitive singular feminine	ποιέω
ποιουένοις	verb: present mid/pass participle, dative plural masculine, verb: present mid/pass participle, dative plural neuter	ποιέω
ποιουένου	verb: present mid/pass participle, genitive singular masculine, verb: present mid/pass participle, genitive singular neuter	ποιέω
ποιουένους	verb: present mid/pass participle, accusative plural masculine	ποιέω
ποιουένων	verb: present mid/pass participle, genitive plural masculine, verb: present mid/pass participle, genitive plural neuter	ποιέω
ποιουένῃ	verb: present mid/pass participle, dative singular feminine	ποιέω
ποιουένῳ	verb: present mid/pass participle, dative singular masculine, verb: present mid/pass participle, dative singular neuter	ποιέω
ποιουενῶν	verb: present mid/pass participle, genitive plural feminine	ποιέω
ποιουμένη	verb: present mid/pass participle, nominative singular feminine	ποιέω
ποιουσῶν	verb: present active participle, genitive plural feminine	ποιέω
ποιούμεθα	verb: present mid/pass indicative, 1st person plural	ποιέω
ποιούμενα	verb: present mid/pass participle, accusative plural neuter, verb: present mid/pass participle, nominative plural neuter	ποιέω
ποιούμεναι	verb: present mid/pass participle, nominative plural feminine	ποιέω
ποιούμενοι	verb: present mid/pass participle, nominative plural masculine	ποιέω
ποιούμενον	verb: present mid/pass participle, accusative singular masculine, verb: present mid/pass participle, accusative singular neuter, verb: present mid/pass participle, nominative singular neuter	ποιέω
ποιούμενος	verb: present mid/pass participle, nominative singular masculine	ποιέω
ποιούντων	verb: present active participle, genitive plural masculine, verb: present active participle, genitive plural neuter	ποιέω
ποιούσαις	verb: present active participle, dative plural feminine	ποιέω
ποιούσας	verb: present active participle, accusative plural feminine	ποιέω
ποιούσης	verb: present active participle, genitive singular feminine	ποιέω
ποιούσῃ	verb: present active participle, dative singular feminine	ποιέω
ποιοῖ	verb: present active optative, 3rd person singular	ποιέω
ποιοῖεν	verb: present active optative, 3rd person plural	ποιέω
ποιοῖμεν	verb: present active optative, 1st person plural	ποιέω
ποιοῖμι	verb: present active optative, 1st person singular	ποιέω
ποιοῖντο	verb: present mid/pass optative, 3rd person plural	ποιέω
ποιοῖο	verb: present mid/pass optative, 2nd person singular	ποιέω
ποιοῖς	verb: present active optative, 2nd person singular	ποιέω
ποιοῖσθε	verb: present mid/pass optative, 2nd person plural	ποιέω
ποιοῖτε	verb: present active optative, 2nd person plural	ποιέω
ποιοῖτο	verb: present mid/pass optative, 3rd person singular	ποιέω
ποιοῦ	verb: present mid/pass imperative, 2nd person singular	ποιέω
ποιοῦμαι	verb: present mid/pass indicative, 1st person singular	ποιέω
ποιοῦμεν	verb: present active indicative, 1st person plural	ποιέω
ποιοῦν	verb: present active participle, accusative singular neuter, verb: present active participle, nominative singular neuter	ποιέω
ποιοῦντα	verb: present active participle, accusative plural neuter, verb: present active participle, accusative singular masculine, verb: present active participle, nominative plural neuter	ποιέω
ποιοῦνται	verb: present mid/pass indicative, 3rd person plural	ποιέω
ποιοῦντας	verb: present active participle, accusative plural masculine	ποιέω
ποιοῦντες	verb: present active participle, nominative plural masculine	ποιέω
ποιοῦντι	verb: present active participle, dative singular masculine, verb: present active participle, dative singular neuter	ποιέω
ποιοῦντος	verb: present active participle, genitive singular masculine, verb: present active participle, genitive singular neuter	ποιέω
ποιοῦσα	verb: present active participle, nominative singular feminine	ποιέω
ποιοῦσαι	verb: present active participle, nominative plural feminine	ποιέω
ποιοῦσαν	verb: present active participle, accusative singular feminine	ποιέω
ποιοῦσι(ν)	verb: present active indicative, 3rd person plural, verb: present active participle, dative plural masculine, verb: present active participle, dative plural neuter	ποιέω
ποιώμεθα	verb: present mid/pass subjunctive, 1st person plural	ποιέω
ποιῆσθε	verb: present mid/pass subjunctive, 2nd person plural	ποιέω
ποιῆται	verb: present mid/pass subjunctive, 3rd person singular	ποιέω
ποιῆτε	verb: present active subjunctive, 2nd person plural	ποιέω
ποιῇ	verb: present active subjunctive, 3rd person singular, verb: present mid/pass subjunctive, 2nd person singular	ποιέω
ποιῇς	verb: present active subjunctive, 2nd person singular	ποιέω
ποιῶ	verb: present active indicative, 1st person singular, verb: present active subjunctive, 1st person singular	ποιέω
ποιῶμαι	verb: present mid/pass subjunctive, 1st person singular	ποιέω
ποιῶμεν	verb: present active subjunctive, 1st person plural	ποιέω
ποιῶν	verb: present active participle, nominative singular masculine	ποιέω
ποιῶνται	verb: present mid/pass subjunctive, 3rd person plural	ποιέω
ποιῶσι(ν)	verb: present active subjunctive, 3rd person plural	ποιέω
ἐποίει	verb: imperfect active indicative, 3rd person singular	ποιέω
ἐποίεις	verb: imperfect active indicative, 2nd person singular	ποιέω
ἐποίουν	verb: imperfect active indicative, 1st person singular, verb: imperfect active indicative, 3rd person plural	ποιέω
ἐποιεῖσθε	verb: imperfect mid/pass indicative, 2nd person plural	ποιέω
ἐποιεῖτε	verb: imperfect active indicative, 2nd person plural	ποιέω
ἐποιεῖτο	verb: imperfect mid/pass indicative, 3rd person singular	ποιέω
ἐποιούμεθα	verb: imperfect mid/pass indicative, 1st person plural	ποιέω
ἐποιούμην	verb: imperfect mid/pass indicative, 1st person singular	ποιέω
ἐποιοῦ	verb: imperfect mid/pass indicative, 2nd person singular	ποιέω
ἐποιοῦμεν	verb: imperfect active indicative, 1st person plural	ποιέω
ἐποιοῦντο	verb: imperfect mid/pass indicative, 3rd person plural	ποιέω
τίμα	verb: present active imperative, 2nd person singular	τιμάω
τιμάσθω	verb: present mid/pass imperative, 3rd person singular	τιμάω
τιμάσθωσαν	verb: present mid/pass imperative, 3rd person plural	τιμάω
τιμάτω	verb: present active imperative, 3rd person singular	τιμάω
τιμάτωσαν	verb: present active imperative, 3rd person plural	τιμάω
τιμωμέναις	verb: present mid/pass participle, dative plural feminine	τιμάω
τιμωμένας	verb: present mid/pass participle, accusative plural feminine	τιμάω
τιμωμένη	verb: present mid/pass participle, nominative singular feminine	τιμάω
τιμωμένην	verb: present mid/pass participle, accusative singular feminine	τιμάω
τιμωμένης	verb: present mid/pass participle, genitive singular feminine	τιμάω
τιμωμένοις	verb: present mid/pass participle, dative plural masculine, verb: present mid/pass participle, dative plural neuter	τιμάω
τιμωμένου	verb: present mid/pass participle, genitive singular masculine, verb: present mid/pass participle, genitive singular neuter	τιμάω
τιμωμένους	verb: present mid/pass participle, accusative plural masculine	τιμάω
τιμωμένων	verb: present mid/pass participle, genitive plural masculine, verb: present mid/pass participle, genitive plural neuter	τιμάω
τιμωμένῃ	verb: present mid/pass participle, dative singular feminine	τιμάω
τιμωμένῳ	verb: present mid/pass participle, dative singular masculine, verb: present mid/pass participle, dative singular neuter	τιμάω
τιμωμενῶν	verb: present mid/pass participle, genitive plural feminine	τιμάω
τιμωσῶν	verb: present active participle, genitive plural feminine	τιμάω
τιμώμεθα	verb: present mid/pass indicative, 1st person plural, verb: present mid/pass subjunctive, 1st person plural	τιμάω
τιμώμενα	verb: present mid/pass participle, accusative plural neuter, verb: present mid/pass participle, nominative plural neuter	τιμάω
τιμώμεναι	verb: present mid/pass participle, nominative plural feminine	τιμάω
τιμώμενοι	verb: present mid/pass participle, nominative plural masculine	τιμάω
τιμώμενον	verb: present mid/pass participle, accusative singular masculine, verb: present mid/pass participle, accusative singular neuter, verb: present mid/pass participle, nominative singular neuter	τιμάω
τιμώμενος	verb: present mid/pass participle, nominative singular masculine	τιμάω
τιμώντων	verb: present active participle, genitive plural masculine, verb: present active participle, genitive plural neuter	τιμάω
τιμώσαις	verb: present active participle, dative plural feminine	τιμάω
τιμώσας	verb: present active participle, accusative plural feminine	τιμάω
τιμώσης	verb: present active participle, genitive singular feminine	τιμάω
τιμώσῃ	verb: present active participle, dative singular feminine	τιμάω
τιμᾶν	verb: present active infinitive	τιμάω
τιμᾶσθαι	verb: present mid/pass infinitive	τιμάω
τιμᾶσθε	verb: present mid/pass indicative, 2nd person plural, verb: present mid/pass subjunctive, 2nd person plural, verb: present mid/pass imperative, 2nd person plural	τιμάω
τιμᾶται	verb: present mid/pass indicative, 3rd person singular, verb: present mid/pass subjunctive, 3rd person singular	τιμάω
τιμᾶτε	verb: present active indicative, 2nd person plural, verb: present active subjunctive, 2nd person plural, verb: present active imperative, 2nd person plural	τιμάω
τιμᾷ	verb: present active indicative, 3rd person singular, verb: present active subjunctive, 3rd person singular, verb: present mid/pass indicative, 2nd person singular, verb: present mid/pass subjunctive, 2nd person singular	τιμάω
τιμᾷς	verb: present active indicative, 2nd person singular, verb: present active subjunctive, 2nd person singular	τιμάω
τιμῴμεθα	verb: present mid/pass optative, 1st person plural	τιμάω
τιμῴμην	verb: present mid/pass optative, 1st person singular	τιμάω
τιμῶ	verb: present active indicative, 1st person singular, verb: present active subjunctive, 1st person singular, verb: present mid/pass imperative, 2nd person singular	τιμάω
τιμῶμαι	verb: present mid/pass indicative, 1st person singular, verb: present mid/pass subjunctive, 1st person singular	τιμάω
τιμῶμεν	verb: present active indicative, 1st person plural, verb: present active subjunctive, 1st person plural	τιμάω
τιμῶν	verb: present active participle, accusative singular neuter, verb: present active participle, nominative singular masculine, verb: present active participle, nominative singular neuter	τιμάω
τιμῶντα	verb: present active participle, accusative plural neuter, verb: present active participle, accusative singular masculine, verb: present active participle, nominative plural neuter	τιμάω
τιμῶνται	verb: present mid/pass indicative, 3rd person plural, verb: present mid/pass subjunctive, 3rd person plural	τιμάω
τιμῶντας	verb: present active participle, accusative plural masculine	τιμάω
τιμῶντες	verb: present active participle, nominative plural masculine	τιμάω
τιμῶντι	verb: present active participle, dative singular masculine, verb: present active participle, dative singular neuter	τιμάω
τιμῶντος	verb: present active participle, genitive singular masculine, verb: present active participle, genitive singular neuter	τιμάω
τιμῶσα	verb: present active participle, nominative singular feminine	τιμάω
τιμῶσαι	verb: present active participle, nominative plural feminine	τιμάω
τιμῶσαν	verb: present active participle, accusative singular feminine	τιμάω
τιμῶσι(ν)	verb: present active indicative, 3rd person plural, verb: present active participle, dative plural masculine, verb: present active participle, dative plural neuter, verb: present active subjunctive, 3rd person plural	τιμάω
τιμῷ	verb: present active optative, 3rd person singular	τιμάω
τιμῷεν	verb: present active optative, 3rd person plural	τιμάω
τιμῷμεν	verb: present active optative, 1st person plural	τιμάω
τιμῷμι	verb: present active optative, 1st person singular	τιμάω
τιμῷντο	verb: present mid/pass optative, 3rd person plural	τιμάω
τιμῷο	verb: present mid/pass optative, 2nd person singular	τιμάω
τιμῷς	verb: present active optative, 2nd person singular	τιμάω
τιμῷσθε	verb: present mid/pass optative, 2nd person plural	τιμάω
τιμῷτε	verb: present active optative, 2nd person plural	τιμάω
τιμῷτο	verb: present mid/pass optative, 3rd person singular	τιμάω
ἐτίμα	verb: imperfect active indicative, 3rd person singular	τιμάω
ἐτίμας	verb: imperfect active indicative, 2nd person singular	τιμάω
ἐτίμων	verb: imperfect active indicative, 1st person singular, verb: imperfect active indicative, 3rd person plural	τιμάω
ἐτιμώμεθα	verb: imperfect mid/pass indicative, 1st person plural	τιμάω
ἐτιμώμην	verb: imperfect mid/pass indicative, 1st person singular	τιμάω
ἐτιμᾶσθε	verb: imperfect mid/pass indicative, 2nd person plural	τιμάω
ἐτιμᾶτε	verb: imperfect active indicative, 2nd person plural	τιμάω
ἐτιμᾶτο	verb: imperfect mid/pass indicative, 3rd person singular	τιμάω
ἐτιμῶ	verb: imperfect mid/pass indicative, 2nd person singular	τιμάω
ἐτιμῶμεν	verb: imperfect active indicative, 1st person plural	τιμάω
ἐτιμῶντο	verb: imperfect mid/pass indicative, 3rd person plural	τιμάω
λυσαμένην	verb: aorist middle participle, accusative singular feminine	λύω
